S2,S2,S2,S2,S2,S2,S2,S2,S2,S2,S2,S2,S2,S2,S2,S2,S2,S2,S2,S2,S2,S2,S2,S2,S2,S2,S2,S2,S2,S2
S2,S2,S2,S2,S2,S2,S2,S2,S2,S2,S2,S2,S2,S2,S2,S2,S2,S2,S2,S2,S2,S2,S2,S2,S2,S2,S2,S2,S2,S2
S2,S2,S2,S2,S2,S2,S2,S2,S2,S2,S2,S2,S2,S2,S2,S2,S2,S2,S2,S2,S2,S2,S2,S2,S2,S2,S2,S2,S2,S2
S2,S2,S1,S1,S1,S1,S1,S1,S1,S1,S1,S1,S1,S1,S1,S1,S1,S1,S1,S1,S1,S2,S2,S2,S2,S2,S2,S2,S2,S2
S2,S2,S1,S1,S1,S1,S1,S1,S1,S1,S1,S1,S1,S1,S1,S1,S1,S1,S1,S1,S1,S2,S2,S2,S2,S2,S2,S2,S2,S2
S2,S2,S1,S1,S1,S1,S1,S1,S1,S1,S1,S1,S1,S1,S1,S1,S1,S1,S1,S1,S1,S2,S2,S2,S2,S2,S2,S2,S2,S2
S2,S2,S1,S1,G1,G1,G1,G1,G1,S1,S1,S1,S1,S1,S1,S1,S1,S1,S1,S1,S1,S2,S2,S2,S2,S2,S2,S2,S2,S2
S2,S2,S1,S1,G1,G1,G1,G1,G1,G1,G1,G1,G1,G1,G1,G1,G1,G1,G1,G1,S1,S2,S2,S2,S2,S2,S2,S2,S2,S2
S2,S2,S1,S1,G1,G1,G1,G1,G1,G1,G1,G1,G1,G1,G1,G1,G1,G1,G1,G1,S1,S2,S2,S2,S2,S2,S2,S2,S2,S2
S2,S2,S1,S1,G1,G1,G1,G1,G1,S1,S1,S1,S1,S1,S1,S1,S1,S1,S1,S1,S1,S2,S2,S2,S2,S2,S2,S2,S2,S2
S2,S2,S1,S1,S1,S1,G1,G1,G1,G1,S1,S1,S1,S1,S1,S1,S1,S1,S1,S1,S1,S2,S2,S2,S2,S2,S2,S2,S2,S2
S2,S2,S1,S1,S1,S1,G1,G1,G1,G1,S1,S1,S1,S1,S1,S1,S1,S1,S1,S1,S1,S2,S2,S2,S2,S2,S2,S2,S2,S2
S2,S2,S2,S2,G1,G1,G2,G2,G2,G2,G1,G1,S2,S2,S2,S2,S2,S2,S2,S2,S2,S2,S2,S2,S2,S2,S2,S2,S2,S2
S2,S2,S2,S2,G1,G1,G2,G2,G2,G2,G1,G1,S2,S2,S2,S2,S2,S2,S2,S2,S2,S2,S2,S2,S2,S2,S2,S2,S2,S2
S2,S2,S2,S2,G1,G1,G2,G2,G2,G2,G1,G1,S2,S2,S2,S2,S2,S2,S2,S2,S2,S2,S2,S2,S2,S2,S2,S2,S2,S2
S2,S2,S2,S2,G1,G1,G2,G2,G2,G2,G1,G1,S2,S2,S2,S2,S2,S2,S2,S2,S2,S2,S2,S2,S2,S2,S2,S2,S2,S2
S2,S2,S2,S2,G1,G1,G2,G2,G2,G2,G1,G1,S2,S2,S2,S2,S2,S2,S2,S2,S2,S2,S2,S2,S2,S2,S2,S2,S2,S2
S2,S2,S2,S2,G1,G1,S2,S2,S2,S2,G1,G1,S2,S2,S2,S2,S2,S2,S2,S2,S2,S2,S2,S2,S2,S2,S2,S2,S2,S2
S2,S2,S2,S2,G1,G1,S2,S2,S2,S2,G1,G1,S2,S2,S2,S2,S2,S2,S2,S2,S2,S2,S2,S2,S2,S2,S2,S2,S2,S2
S2,S2,S2,S2,S2,S2,S2,S2,S2,S2,S2,S2,S2,S2,S2,S2,S2,S2,S2,S2,S2,S2,S2,S2,S2,S2,S2,S2,S2,S2
S2,S2,S2,S2,S2,S2,S2,S2,S2,S2,S2,S2,S2,S2,S2,S2,S2,S2,S2,S2,S2,S2,S2,S2,S2,S2,S2,S2,S2,S2
S2,S2,S2,S2,S2,S2,S2,S2,S2,S2,S2,S2,S2,S2,S2,S2,S2,S2,S2,S2,S2,S2,S2,S2,S2,S2,S2,S2,S2,S2
S2,S2,S2,S2,S2,S2,S2,S2,S2,S2,S2,S2,S2,S2,S2,S2,S2,S2,S2,S2,S2,S2,S2,S2,S2,S2,S2,S2,S2,S2
S2,S2,S2,S2,S2,S2,S2,S2,S2,S2,S2,S2,S2,S2,S2,S2,S2,S2,S2,S2,S2,S2,S2,S2,S2,S2,S2,S2,S2,S2
S2,S2,S2,S2,S2,S2,S2,S2,S2,S2,S2,S2,S2,S2,S2,S2,S2,S2,S2,S2,S2,S2,S2,S2,S2,S2,S2,S2,S2,S2
S2,S2,S2,S2,S2,S2,S2,S2,S2,S2,S2,S2,S2,S2,S2,S2,S2,S2,S2,S2,S2,S2,S2,S2,S2,S2,S2,S2,S2,S2
S2,S2,S2,S2,S2,S2,S2,S2,S2,S2,S2,S2,S2,S2,S2,S2,S2,S2,S2,S2,S2,S2,S2,S2,S2,S2,S2,S2,S2,S2